%%%%%%%%%%%%%%%%%%%%%%%%
%          GG          %
%%%%%%%%%%%%%%%%%%%%%%%%
% % %%%%%%%%%%%%%%%%P%%%
%%%%%%%%%%%%%%%%%%%%%%%%
